 You are a knight in training at the prestigious Hyrule Academy. It's a good thing you woke up early today because you need to get to training...but first you need to find your equipment.                                                                                                                                                                                                                    MISSION: obtain basic training equipment                                                               (your SWORD and SHIELD)
youXI
An Interactive Fiction by Nicole Baptist
Release 1 / Serial number 141006 / Inform 7 build 6L38 (I6/v6.33 lib 6/12N) SD

your room
A simple room with wooden flooring, and grey-white walls with an emerald trim: your academy's colors. The only pieces of furniture are your bed, your closet, your desk, a trunk, and a chair. The exit is to the south.

You can see your bed here.

>exit room
I only understood you as far as wanting to exit.

>exit south
I only understood you as far as wanting to exit.

>examine desk
You usually leave your equipment here for the next day...unfortunately, your equipment is obviously gone.

>examine trunk
You open the trunk to find all of your most special possesions: family, pictures, a few old figurines...nothing particularly useful at the moment.

>examine chair
A chair fit for a knight.

>examine bed
A nice, comfortable bed to relax in after a day full of knight training.

I beg your pardon?

>opn closet
That's not a verb I recognise.

>open closet
It isn't something you can open.

>examine closet
You open your closet to find a piece of paper clipped on to one of your spare uniforms.

>read paper
The note reads: your equipment is nowhere to be seen... unfortunately they aren't meant to be used to clean.

>put on uniform
You can't see any such thing.

>exit
But you aren't in anything at the moment.

>examine pictures
You can't see any such thing.

>sleep
You aren't feeling especially drowsy.

>push bed
It is fixed in place.

>push trunk
It is fixed in place.

>l
your room
A simple room with wooden flooring, and grey-white walls with an emerald trim: your academy's colors. The only pieces of furniture are your bed, your closet, your desk, a trunk, and a chair. The exit is to the south.

You can see your bed here.

>s exit
I only understood you as far as wanting to (go) s.

>s
hallway
A simple hallway with maps and posters along the wall. To the north is your room, north east is Pipit's room, east leads further into the academy, west leads outside, south west is to the bathroom, and south leads to the dining hall.

You can see maps and posters here.

>examine maps
Maps of your home floating island, Skyloft.

>ex poster
That's not a verb I recognise.

>examine poster
You can't see any such thing.

>e
You can't go that way.

>east
You can't go that way.

>ne
Pipit's room
Pipit's room is a little more lively, as he has added more posters to the walls, has placed figurines on his desk, and has a beanbag in the cornner. The exit is to the southwest.

You can see Pipit's bean bag, Pipit's bed and Pipit's posters here.

>sw
hallway
A simple hallway with maps and posters along the wall. To the north is your room, north east is Pipit's room, east leads further into the academy, west leads outside, south west is to the bathroom, and south leads to the dining hall.

You can see maps and posters here.

>examin maps
That's not a verb I recognise.

>examine maps
Maps of your home floating island, Skyloft.

>sw
bathroom
A rather spacious room with  a toilet, a sink, and a large tub. The exit is to the north east.

>ne
hallway
A simple hallway with maps and posters along the wall. To the north is your room, north east is Pipit's room, east leads further into the academy, west leads outside, south west is to the bathroom, and south leads to the dining hall.

You can see maps and posters here.

>s
dining hall
A spacious dining hall with long tables and benches. Along the windows is a table separated from the others with trays, napkins, and utensils.

>n
hallway
A simple hallway with maps and posters along the wall. To the north is your room, north east is Pipit's room, east leads further into the academy, west leads outside, south west is to the bathroom, and south leads to the dining hall.

You can see maps and posters here.

* * *

>x trunk
you open the trunk to find all of your most special possesions: letters from friends and family, pictures, a few old figurines...nothing particularly useful at the moment.

>x bed
a nice, comfortable bed to relax in after a day full of knight training.

>enter bed
You get onto your bed.

>x desk
you usually leave your equipment here for the next day...unfortunately, your equipment is obviously gone.

>x chair
a chair fit for a knight.

>x closet
you open your closet to find a note clipped on to one of your spare uniforms.

* * *

>x closet
You open your closet to find a piece of paper clipped on to one of your spare uniforms.

>x paper
The note reads: your equipment is nowhere to be seen... your shield meant to be used to clean. and what about your sword? where is that? I'll let you know, it's under something hard, and flat.

>s
hallway
A simple hallway with maps and posters along the wall. To the north is your room, north east is Pipit's room, east leads further into the academy, west leads outside, south west is to the bathroom, and south leads to the dining hall.

You can see maps and posters here.

>sw
bathroom
A rather spacious room with  a toilet, a sink, and a large tub. The exit is to the north east.

>x tub
Made from a natural hotspring, the tub is always full of warm water. Looking closely, though, you see something at the bottom...it looks like you can reach in to grab it.

>reach in tub
You reach your hand inside the tub, and find your shield!                         (Maybe your should check it to make sure your friends didn't break it.)

>x shield
A shiny, stainless steel shield with a few scratches from sparring matches against your particularly talented classmates. It has the academy crest engraved on it. Attached to the back is what looks like a potion container.

>x container
Inside you are able to read a small note.

>x note
The second riddle reads, ah, so you've found your shield... but you also need a weapon to wield. for training you need no papers or pencils... instead, try looking by the utensils?

>ne
hallway
A simple hallway with maps and posters along the wall. To the north is your room, north east is Pipit's room, east leads further into the academy, west leads outside, south west is to the bathroom, and south leads to the dining hall.

You can see maps and posters here.

* * *

>s
dining hall
A spacious dining hall with long tables and benches. Along the windows is a table separated from the others with trays, napkins, and utensils.

>x table
You reach your hand under the table, and find your sword!                         (Maybe your should check it to make sure your friends didn't break it.)

>x sword
A sharp, lightweight, yet durable sword. There is a note attached to the hilt that reads,                                                                                                              If you haven't found your shield yet, well I'd rather not face your wrath...so I'll just let you know that it's where you take a bath.

>n
hallway
A simple hallway with maps and posters along the wall. To the north is your room, north east is Pipit's room, east leads further into the academy, west leads outside, south west is to the bathroom, and south leads to the dining hall.

You can see maps and posters here.

>e
You can't go that way.

>w
outdoors
A nice, large grassy field. You see your teacher, Horwell.

You can see Horwell here.

>talk to horwell
You'll need your shield and sword in order to participate in training today. Can you show them to me?

>SHOW shield
(to Horwell)
Good! Now you will be able to block attacks.

[Your score has just gone up by one point.]

>show sword
(to Horwell)
Great! Now you can counter your opponents" attacks.

    *** Excellent! Now we can start today's training. YOU WIN. ***

In that game you scored 2 out of a possible 2, in 19 turns.

Would you like to RESTART, RESTORE a saved game, QUIT or UNDO the last command?

>restart
 You are a knight in training at the prestigious Hyrule Academy. It's a good thing you woke up early today because you need to get to training...but first you need to find your equipment.

youXI
An Interactive Fiction by Nicole Baptist
Release 1 / Serial number 141006 / Inform 7 build 6L38 (I6/v6.33 lib 6/12N) SD

your room
A simple room with wooden flooring, and grey-white walls with an emerald trim: your academy's colors. The only pieces of furniture are your bed, your closet, your desk, a trunk, and a chair. The exit is to the south.

You can see your bed here.

>x closet
You open your closet to find a piece of paper clipped on to one of your spare uniforms.

* * *

>s
hallway
A simple hallway with maps and posters along the wall. To the north is your room, north east is Pipit's room, east leads further into the academy, west leads outside, south west is to the bathroom, and south leads to the dining hall.

You can see maps and posters here.

>s
dining hall
A spacious dining hall with long tables and benches. Along the windows is a table separated from the others with trays, napkins, and utensils.

* * *

>n
hallway
A simple hallway with maps and posters along the wall. To the north is your room, north east is Pipit's room, east leads further into the academy, west leads outside, south west is to the bathroom, and south leads to the dining hall.

You can see maps and posters here.

>sw
bathroom
A rather spacious room with  a toilet, a sink, and a large tub. The exit is to the north east.

* * *

>reach in tub
You reach your hand inside the tub, and find your shield!                         (Maybe your should check it to make sure your friends didn't break it.)

>ne
hallway
A simple hallway with maps and posters along the wall. To the north is your room, north east is Pipit's room, east leads further into the academy, west leads outside, south west is to the bathroom, and south leads to the dining hall.

You can see maps and posters here.

>e
You can't go that way.

* * *

>S
hallway
a simple hallway with maps and posters along the wall. to the north is your room, north east is Pipit's room, east leads further into the academy, west leads outside, south west is to the bathroom, and south leads to the kitchen.

You can see maps and posters here.

>SW
bathroom

>x tub
made from a natural hotspring, the tub is always full of warm water. looking closely, though, you see something at the bottom...it looks like you can reach it.

>reach inside tub
you reach your empty hand inside the tub, and find your shield!.

>i
You are carrying:
  your shield

>x shield
a shiny, stainless steel shield with a few scratches from sparring matches against your particularly talented classmates.

>wear shield
You put on your shield.

* * *

>i
You are carrying nothing.

>s
hallway
a simple hallway with maps and posters along the wall. to the north is your room, north east is Pipit's room, east leads further into the academy, west leads outside, south west is to the bathroom, and south leads to the dining hall.

You can see maps and posters here.

>s
dining hall
a spacious dining hall with long tables and benches. along the windows is a table separated from the others with trays, napkins, and utensils.

>x tble
You can't see any such thing.

>x table
you reach your hand under the table, and find your sword!                         now you are ready for training! (and just in time, too!)

>i
You are carrying:
  your sword

>s
You can't go that way.

>n
hallway
a simple hallway with maps and posters along the wall. to the north is your room, north east is Pipit's room, east leads further into the academy, west leads outside, south west is to the bathroom, and south leads to the dining hall.

You can see maps and posters here.

>w
outdoors
a nice, large grassy field. you see your teacher, Horwell.

You can see Horwell here.

>show sword to horwell
    *** excellent! now we can start today's training. YOU WIN. ***

Would you like to RESTART, RESTORE a saved game, QUIT or UNDO the last command?

* * *

>x bed
A nice, comfortable bed to relax in after a day full of knight training.

>x closet
You open your closet to find a piece of paper clipped on to one of your spare uniforms.

>x paper
The note reads: your equipment is nowhere to be seen... unfortunately they aren't meant to be used to clean.

>take note
You can't see any such thing.

>take paper
That's hardly portable.

>x desk
You usually leave your equipment here for the next day...unfortunately, your equipment is obviously gone.

>x trunk
You open the trunk to find all of your most special possesions: family, pictures, a few old figurines...nothing particularly useful at the moment.

>x chair
A chair fit for a knight.

>s
hallway
A simple hallway with maps and posters along the wall. To the north is your room, north east is Pipit's room, east leads further into the academy, west leads outside, south west is to the bathroom, and south leads to the dining hall.

You can see maps and posters here.

>x map
You can't see any such thing.

>x maps
Maps of your home floating island, Skyloft.

>take maps
Taken.

>x posters
The posters show different combat moves.

>take posters
Taken.

>i
You are carrying:
  posters
  maps

>ne
Pipit's room
Pipit's room is a little more lively, as he has added more posters to the walls, has placed figurines on his desk, and has a beanbag in the cornner. The exit is to the southwest.

You can see Pipit's bean bag, Pipit's bed and Pipit's posters here.

>x bean ba
I only understood you as far as wanting to examine Pipit's bean bag.

>x bean bag
A nice comfortable bean bag that could also be used to hide under to cut class?

>x posters
(posters)
The posters show different combat moves.

>x pipit's posters
His posters aren't actually posters...they're drawings he's made. (And very nice ones at that.)

>x figurines
You can't see any such thing.

>x bed
Pipit is still sleeping. Fortunately for him, his equipment isn't missing.

>enter bed
DUDE. HE'S STILL SLEEPING HERE.

>enter bean bag
(getting off Pipit's bed)
Cushion-ey.

>get off bean bag
You get off Pipit's bean bag.

Pipit's room
Pipit's room is a little more lively, as he has added more posters to the walls, has placed figurines on his desk, and has a beanbag in the cornner. The exit is to the southwest.

You can see Pipit's bean bag, Pipit's bed and Pipit's posters here.

>x desk
There are more WIP drawings cluttered on his desk.

>se
You can't go that way.

>sw
hallway
A simple hallway with maps and posters along the wall. To the north is your room, north east is Pipit's room, east leads further into the academy, west leads outside, south west is to the bathroom, and south leads to the dining hall.

>e
You can't go that way.

* * *

>talk to horwell
You'll need your shield and sword in order to participate in training today. Can you show them to me?

>x horwell
Horwell is a tall, muscular figure carved into what he is today from years of training academy students.

>e
hallway
A simple hallway with maps and posters along the wall. To the north is your room, north east is Pipit's room, east leads further into the academy, west leads outside, south west is to the bathroom, and south leads to the dining hall.

>s
dining hall
A spacious dining hall with long tables and benches. Along the windows is a table separated from the others with trays, napkins, and utensils.

>x table
You reach your hand under the table, and find your sword!                         Now you are ready for training! (And just in time, too!)

>n
hallway
A simple hallway with maps and posters along the wall. To the north is your room, north east is Pipit's room, east leads further into the academy, west leads outside, south west is to the bathroom, and south leads to the dining hall.

>se
You can't go that way.

>sw
bathroom
A rather spacious room with  a toilet, a sink, and a large tub. The exit is to the north east.

>reach inside tub
I didn't understand that sentence.

>reach in tub
You reach your hand inside the tub, and find your shield!                         (Maybe your should check it to make sure your friends didn't break it.)

[Your score has just gone up by one point.]

>ne
hallway
A simple hallway with maps and posters along the wall. To the north is your room, north east is Pipit's room, east leads further into the academy, west leads outside, south west is to the bathroom, and south leads to the dining hall.

>w
outdoors
A nice, large grassy field. You see your teacher, Horwell.

You can see Horwell here.

* * *

>show sword
(to Horwell)

    *** Excellent! Now we can start today's training. YOU WIN. ***

In that game you scored 1 out of a possible 2, in 39 turns.

Would you like to RESTART, RESTORE a saved game, QUIT or UNDO the last command?

* * *

>x closet
You open your closet to find a piece of paper clipped on to one of your spare uniforms.

>x trunk
you open the trunk to find all of your most special possesions: family, pictures, a few old figurines...nothing particularly useful at the moment.

I beg your pardon?

>x a chair
a chair fit for a knight.

>take all
There are none at all available!

>get all
There are none at all available!

>x bed
a nice, comfortable bed to relax in after a day full of knight training.

>s
hallway
a simple hallway with maps and posters along the wall. to the north is your room, north east is Pipit's room, east leads further into the academy, west leads outside, south west is to the bathroom, and south leads to the dining hall.

You can see maps and posters here.

>e
You can't go that way.

>e
You can't go that way.

>northeast
Pipit's room
Pipit's room is a little more lively, as he has added more posters to the walls, has placed figurines on his desk, and has a beanbag in the cornner. the exit is to the southwest.

You can see Pipit's bed and Pipit's posters here.

>x posters
his posters aren't actually posters...they're drawings he's made. (and very nice ones at that.)

>x desk
there are more WIP drawings cluttered on his desk.

>x beanbag
You can't see any such thing.

>x corner
You can't see any such thing.

>xcornner
That's not a verb I recognise.

>x figurines
You can't see any such thing.

>x figurines
You can't see any such thing.

>x desk
there are more WIP drawings cluttered on his desk.

>southeast
You can't go that way.

>southeast
You can't go that way.

>southwest
hallway
a simple hallway with maps and posters along the wall. to the north is your room, north east is Pipit's room, east leads further into the academy, west leads outside, south west is to the bathroom, and south leads to the dining hall.

You can see maps and posters here.

>x maps
maps of your home floating island, Skyloft.

>x poster
You can't see any such thing.

>southwest
bathroom
a rather spacious room with  a toilet, a sink, and a large tub. the exit is to the north east.

>x toliet
You can't see any such thing.

>x sink
a nice, clean sink.

>x large tub
You can't see any such thing.

>x tub
made from a natural hotspring, the tub is always full of warm water. looking closely, though, you see something at the bottom...it looks like you can reach it.

>take tub
That's hardly portable.

>x thing
You can't see any such thing.

>get all
There are none at all available!

>take all
There are none at all available!

>open tub
It isn't something you can open.

>drain tub
That's not a verb I recognise.

>take something at the bottom
You can't see any such thing.

>reach bottom
I didn't understand that sentence.

>get bottom
You can't see any such thing.

>southeast
You can't go that way.

>southwest
You can't go that way.

>northwest
You can't go that way.

>north
You can't go that way.

>northeast
hallway
a simple hallway with maps and posters along the wall. to the north is your room, north east is Pipit's room, east leads further into the academy, west leads outside, south west is to the bathroom, and south leads to the dining hall.

You can see maps and posters here.

>south
dining hall
a spacious dining hall with long tables and benches. along the windows is a table separated from the others with trays, napkins, and utensils.

>x tabl
You can't see any such thing.

>x table
you reach your hand under the table, and find your sword!                         now you are ready for training! (and just in time, too!)

>x sword
a sharp, lightweight, yet durable sword.

>s
You can't go that way.

>e
You can't go that way.

>s
You can't go that way.

* * *

>n
hallway
a simple hallway with maps and posters along the wall. to the north is your room, north east is Pipit's room, east leads further into the academy, west leads outside, south west is to the bathroom, and south leads to the dining hall.

You can see maps and posters here.

>e
You can't go that way.

>w
outdoors
a nice, large grassy field. you see your teacher, Horwell.

You can see Horwell here.

>x horwell
Horwell is a tall, muscular figure carved into what he is today from years of training academy students.

>talk to horwell
you'll need your shield and sword in order to participate in training today. can you show them to me?

>e
hallway
a simple hallway with maps and posters along the wall. to the north is your room, north east is Pipit's room, east leads further into the academy, west leads outside, south west is to the bathroom, and south leads to the dining hall.

You can see maps and posters here.

>w
outdoors
a nice, large grassy field. you see your teacher, Horwell.

You can see Horwell here.

>e
hallway
a simple hallway with maps and posters along the wall. to the north is your room, north east is Pipit's room, east leads further into the academy, west leads outside, south west is to the bathroom, and south leads to the dining hall.

You can see maps and posters here.

>southwest
bathroom
a rather spacious room with  a toilet, a sink, and a large tub. the exit is to the north east.

>take shield'
You can't see any such thing.

>take shield
You can't see any such thing.

>x shield
You can't see any such thing.

>x tub
made from a natural hotspring, the tub is always full of warm water. looking closely, though, you see something at the bottom...it looks like you can reach it.

>x toliet
You can't see any such thing.

>/
That's not a verb I recognise.

>l
bathroom
a rather spacious room with  a toilet, a sink, and a large tub. the exit is to the north east.

>x sink
a nice, clean sink.

>x toliet
You can't see any such thing.

>x tub
made from a natural hotspring, the tub is always full of warm water. looking closely, though, you see something at the bottom...it looks like you can reach it.

>drain tub
That's not a verb I recognise.

>n
You can't go that way.

>e
You can't go that way.

* * *

>s
You can't go that way.

>northwest
You can't go that way.

>ne
hallway
a simple hallway with maps and posters along the wall. to the north is your room, north east is Pipit's room, east leads further into the academy, west leads outside, south west is to the bathroom, and south leads to the dining hall.

You can see maps and posters here.

>ne
Pipit's room
Pipit's room is a little more lively, as he has added more posters to the walls, has placed figurines on his desk, and has a beanbag in the cornner. the exit is to the southwest.

You can see Pipit's bed and Pipit's posters here.

>x bed
Pipit is still sleeping. Fortunately for him, his equipment isn't missing.

>take shield
You can't see any such thing.

>take equipment
You can't see any such thing.

>x pipit
You can't see any such thing.

>x equipment
You can't see any such thing.

>enter pipit's bed
DUDE. CAN'T YOU SEE HE'S STILL SLEEPING HERE?

>x closet
it's locked.

>northeast
(first getting off Pipit's bed)
You can't go that way.

>n
You can't go that way.

>nw
You can't go that way.

>n
You can't go that way.

* * *

>s
You can't go that way.

>w
You can't go that way.

>e
You can't go that way.

>se
You can't go that way.

>l
Pipit's room
Pipit's room is a little more lively, as he has added more posters to the walls, has placed figurines on his desk, and has a beanbag in the cornner. the exit is to the southwest.

You can see Pipit's bed and Pipit's posters here.

>sw
hallway
a simple hallway with maps and posters along the wall. to the north is your room, north east is Pipit's room, east leads further into the academy, west leads outside, south west is to the bathroom, and south leads to the dining hall.

You can see maps and posters here.

>sw
bathroom
a rather spacious room with  a toilet, a sink, and a large tub. the exit is to the north east.

>reach into tub
I didn't understand that sentence.

>reach inside tub
you reach your hand inside the tub, and find your shield!                         (Maybe your should check it to make sure your friends didn't break it.)

>e
You can't go that way.

>n
You can't go that way.

>w
You can't go that way.

>south
You can't go that way.

>l
bathroom
a rather spacious room with  a toilet, a sink, and a large tub. the exit is to the north east.

>ne
hallway
a simple hallway with maps and posters along the wall. to the north is your room, north east is Pipit's room, east leads further into the academy, west leads outside, south west is to the bathroom, and south leads to the dining hall.

You can see maps and posters here.

>w
outdoors
a nice, large grassy field. you see your teacher, Horwell.

You can see Horwell here.

>attack horwell
Violence isn't the answer to this one.

>talk to horwell
you'll need your shield and sword in order to participate in training today. can you show them to me?

>show sword and shield
You can't use multiple objects with that verb.

>show sword
(to Horwell)
excellent! now we can start training.                      YOU WIN.

>show shield
(to Horwell)
good. now, do you have your sword?

>wear sword
You put on your sword.

>wear shield
You put on your shield.

* * *

>s
hallway
A simple hallway with maps and posters along the wall. To the north is your room, north east is Pipit's room, east leads further into the academy, west leads outside, south west is to the bathroom, and south leads to the dining hall.

You can see maps and posters here.

* * *

>sw
bathroom
A rather spacious room with  a toilet, a sink, and a large tub. The exit is to the north east.

>reach into tub
You reach your hand inside the tub, and find your shield!                         (Maybe your should check it to make sure your friends didn't break it.)

>search tub
You find nothing of interest.

>s
You can't go that way.

>sw
You can't go that way.

>search tub
You find nothing of interest.

>really? dammit
That's not a verb I recognise.

* * *

>sw
bathroom
A rather spacious room with  a toilet, a sink, and a large tub. The exit is to the north east.

>reach in tub
You reach your hand inside the tub, and find your shield!                         (Maybe your should check it to make sure your friends didn't break it.)

>reach into tub
I didn't understand that sentence.

>reach inside tub
You reach your hand inside the tub, and find your shield!                         (Maybe your should check it to make sure your friends didn't break it.)

>reach into tub
I didn't understand that sentence.

>search tub
You find nothing of interest.

* * *

>s
dining hall
A spacious dining hall with long tables and benches. Along the windows is a table separated from the others with trays, napkins, and utensils.

>x sword
You can't see any such thing.

>x table
You reach your hand under the table, and find your sword!                         (Maybe your should check it to make sure your friends didn't break it.)

* * *

>s
dining hall
A spacious dining hall with long tables and benches. Along the windows is a table separated from the others with trays, napkins, and utensils.

>x tables
ridiculously long tables to go with the ridiculously long benches.

>x benches
ridiculously long benchs to go with the ridiculously long tables.

>x table
you reach your hand under the table, and find your sword!                         now you are ready for training! (and just in time, too!)

>n
hallway
a simple hallway with maps and posters along the wall. to the north is your room, north east is Pipit's room, east leads further into the academy, west leads outside, south west is to the bathroom, and south leads to the dining hall.

You can see maps and posters here.

>i
You are carrying:
  your sword

>e
You can't go that way.

>w
outdoors

* * *

>x table
You reach your hand under the table, and find your sword!                         (Maybe your should check it to make sure your friends didn't break it.)

>n
hallway
a simple hallway with maps and posters along the wall. to the north is your room, north east is Pipit's room, east leads further into the academy, west leads outside, south west is to the bathroom, and south leads to the dining hall.

You can see maps and posters here.

* * *

>x table
You reach your hand under the table, and find your sword!                         (Maybe your should check it to make sure your friends didn't break it.)

>x sword
A sharp, lightweight, yet durable sword. There is a note attached to the hilt that reads,                                                                                                       If you haven't found your shield yet, well I'd rather not face your wrath...so I'll just let you know that it's where you take a bath.

* * *

>s
hallway
A simple hallway with maps and posters along the wall. To the north is your room, north east is Pipit's room, east leads further into the academy, west leads outside, south west is to the bathroom, and south leads to the dining hall.

You can see maps and posters here.

>we
That's not a verb I recognise.

>sw
bathroom
a rather spacious room with  a toilet, a sink, and a large tub.

>reach inside tub
you reach your hand inside the tub, and find your shield!                         (Maybe your should check it to make sure your friends didn't break it.)

>x shield
a shiny, stainless steel shield with a few scratches from sparring matches against your particularly talented classmates. it has the academy crest engraved on it. attached to the back is what looks like a potion container.

>x potion container
I only understood you as far as wanting to examine the potion.