You are a knight in training at the prestigious Hyrule Academy. It's a good thing you woke up early today because you need to get to training...but first you need to find your equipment.     MISSION: obtain basic training equipment (your SWORD and SHIELD)
youXI
An Interactive Fiction by Nicole Baptist
Release 1 / Serial number 141007 / Inform 7 build 6L38 (I6/v6.33 lib 6/12N) SD

Your room
A simple room with wooden flooring, and grey-white walls with an emerald trim: your academy's colors. The only pieces of furniture are your bed, your closet, your desk, a trunk, and a chair. The exit is to the south.

You can see your bed, your chair and a trunk (closed) here.

>x closet
You open your closet to find a piece of paper clipped on to one of your spare uniforms.

* * *

>attack
What do you want to attack?

>kill with dick
You can't see any such thing.

>die
That's not a verb I recognise.

>die
That's not a verb I recognise.

* * *

>s
hallway
A simple hallway with maps and flyers along the wall. To the north is your room, north east is Pipit's room, east leads further into the academy, west leads outside, south west is to the bathroom, and south leads to the dining hall.

You can see Maps and Flyers here.

>sw
bathroom
A rather spacious room with  a toilet, a sink, a mirror, and a large tub. The exit is to the north east.

>reach inside tub
You reach your hand inside the tub, and find your shield!                         (Maybe your should check it to make sure your friends didn't break it.)

>wear shield
You put on your shield.

>ne
hallway
A simple hallway with maps and flyers along the wall. To the north is your room, north east is Pipit's room, east leads further into the academy, west leads outside, south west is to the bathroom, and south leads to the dining hall.

You can see maps and flyers here.

>s
dining hall
A spacious dining hall with long tables and benches. Along the windows is a table separated from the others with trays, napkins, and utensils.

>x table
You reach your hand under the table, and find your sword!                         (Maybe your should check it to make sure your friends didn't break it.)

>n
hallway
A simple hallway with maps and flyers along the wall. To the north is your room, north east is Pipit's room, east leads further into the academy, west leads outside, south west is to the bathroom, and south leads to the dining hall.

You can see maps and flyers here.

>e
You can't go that way.

>w
outdoors
A nice, large grassy field. You see your teacher, Horwell, and Pipit.

You can see Horwell and Pipit here.

>talk to horwell
You'll need your shield and sword in order to participate in training today. Can you show them to me?

>show sword
Whom do you want to show your sword to?

>show shield
Whom do you want to show your shield to?

>horwell
Good! Now you will be able to block attacks.

[Your score has just gone up by one point.]

>show sword to horwell
Great! Now you can counter your opponents" attacks.

Now we can begin today's training. Why don't we start off with some old-fasioned sparring? Put on your equipment and attack Pipit when you're ready.

[Your score has just gone up by one point.]

>wear sword
You put on your sword.

Now we can begin today's training. Why don't we start off with some old-fasioned sparring? Put on your equipment and attack Pipit when you're ready.

>i
You are carrying:
  your sword (being worn)
  your shield (being worn)

Now we can begin today's training. Why don't we start off with some old-fasioned sparring? Put on your equipment and attack Pipit when you're ready.

>talk to pipit
I can't wait to start training!

Now we can begin today's training. Why don't we start off with some old-fasioned sparring? Put on your equipment and attack Pipit when you're ready.

>attack pipit
You attack Pipit, causing 8 points of damage!

Pipit attacks you, causing 2 points of damage!

Now we can begin today's training. Why don't we start off with some old-fasioned sparring? Put on your equipment and attack Pipit when you're ready.

>attack pipit
You attack Pipit, causing 3 points of damage!

Pipit attacks you, causing 3 points of damage!

Now we can begin today's training. Why don't we start off with some old-fasioned sparring? Put on your equipment and attack Pipit when you're ready.

>attack pipit
You attack Pipit, causing 5 points of damage!

    *** YOU HAVE KNOCKED OUT PIPIT! YOU WIN! ***

In that game you scored 2 out of a possible 2, in 19 turns.

Would you like to RESTART, RESTORE a saved game, QUIT or UNDO the last command?

* * *

>sw
bathroom
A rather spacious room with  a toilet, a sink, a mirror, and a large tub. The exit is to the north east.

>reach in tub
You reach your hand inside the tub, and find your shield!                         (Maybe your should check it to make sure your friends didn't break it.)

>ne
hallway
A simple hallway with maps and flyers along the wall. To the north is your room, north east is Pipit's room, east leads further into the academy, west leads outside, south west is to the bathroom, and south leads to the dining hall.

You can see maps and flyers here.

* * *

>n
hallway
A simple hallway with maps and flyers along the wall. To the north is your room, north east is Pipit's room, east leads further into the academy, west leads outside, south west is to the bathroom, and south leads to the dining hall.

You can see maps and flyers here.

>w
outdoors
A nice, large grassy field. You see your teacher, Horwell, and Pipit.

You can see Horwell and Pipit here.

>wear shield
You put on your shield.

>wear sword
You put on your sword.

>show sword to horwell
Great! Now you can counter your opponents" attacks.

[Your score has just gone up by one point.]

>show shield to horwell
Good! Now you will be able to block attacks.

Now we can begin today's training. Why don't we start off with some old-fasioned sparring? Put on your equipment and attack Pipit when you're ready.

[Your score has just gone up by two points.]

>talk to pipit
I can't wait to start training!

>attack pipit
You attack Pipit, causing 3 points of damage!

Pipit attacks you, causing 2 points of damage!

>attack pipit
You attack Pipit, causing 2 points of damage!

Pipit attacks you, causing 6 points of damage!

>attack pipit
You attack Pipit, causing 3 points of damage!

Pipit attacks you, causing 5 points of damage!

>attack pipit
You attack Pipit, causing 7 points of damage!

Pipit attacks you, causing 5 points of damage!

    *** YOU HAVE BEEN DEFEATED. ***

In that game you scored 3 out of a possible 3, in 18 turns.

Would you like to RESTART, RESTORE a saved game, QUIT or UNDO the last command?

>undo
outdoors
[Previous turn undone.]

>undo
outdoors
[Previous turn undone.]

>talk to horwell
You'll need your shield and sword in order to participate in training today. Can you show them to me?

* * *

>show sword
Whom do you want to show your sword to?

>horwell
Great! Now you can counter your opponents" attacks.

[Your score has just gone up by one point.]

>show shield
Whom do you want to show your shield to?

* * *

>horwell
Good! Now you will be able to block attacks.

[Your score has just gone up by one point.]

>attack pipit
You attack Pipit, causing 4 points of damage!

Pipit attacks you, causing 4 points of damage!

>attack pipit
You attack Pipit, causing 7 points of damage!

Pipit attacks you, causing 6 points of damage!

>attack pipit
You attack Pipit, causing 2 points of damage!

Pipit attacks you, causing 8 points of damage!

    *** YOU HAVE BEEN DEFEATED. ***

In that game you scored 5 out of a possible 3, in 20 turns.

Would you like to RESTART, RESTORE a saved game, QUIT or UNDO the last command?

* * *

>s
hallway
A simple hallway with maps and flyers along the wall. To the north is your room, north east is Pipit's room, east leads further into the academy, west leads outside, south west is to the bathroom, and south leads to the dining hall.

You can see Maps and Flyers here.

>s
dining hall
A spacious dining hall with long tables and benches. Along the windows is a table separated from the others with trays, napkins, and utensils.

>x table
You reach your hand under the table, and find your sword! (Maybe your should check it to make sure your friends didn't break it.)

>n
hallway
A simple hallway with maps and flyers along the wall. To the north is your room, north east is Pipit's room, east leads further into the academy, west leads outside, south west is to the bathroom, and south leads to the dining hall.

You can see Maps and Flyers here.

>sw
bathroom
A rather spacious room with  a toilet, a sink, a mirror, and a large tub. The exit is to the north east.

>reach in tub
You reach your hand inside the tub, and find your shield! (Maybe your should check it to make sure your friends didn't break it.)

>ne
hallway
A simple hallway with maps and flyers along the wall. To the north is your room, north east is Pipit's room, east leads further into the academy, west leads outside, south west is to the bathroom, and south leads to the dining hall.

You can see Maps and Flyers here.

>w
Outdoors
A nice, large grassy field. You see your teacher, Horwell, and your classmate/friend, Pipit.

You can see Horwell and Pipit here.

>show horwell sword
Great! Now you can counter your opponents" attacks.

[Your score has just gone up by one point.]

>show horwell shield
Good! Now you will be able to block attacks.

Now we can begin today's training. Why don't we start off with some old-fasioned sparring? Put on your equipment and attack Pipit when you're ready. Don't worry, he's ready.

[Your score has just gone up by two points.]

>wear sword
You put on your sword.

>wear shield
You put on your shield.

>attack yourself
You can't see any such thing.

>kill yourself
You can't see any such thing.

>attack the shield
Violence isn't the answer to this one.

>attack pipet
You can't see any such thing.

>kill pipet
You can't see any such thing.

>use sword to fook pipet
That's not a verb I recognise.

>kill pipit with swor
I only understood you as far as wanting to kill Pipit.

>kill pipit with sword
I only understood you as far as wanting to kill Pipit.

>attack pipit with sword
I only understood you as far as wanting to attack Pipit.

>attack
What do you want to attack?

>attack pipit
You attack Pipit, causing 4 points of damage!

Pipit attacks you, causing 3 points of damage!

>attack pipit
You attack Pipit, causing 4 points of damage!

Pipit attacks you, causing 4 points of damage!

* * *

>x bed
A nice, comfortable bed to relax in after a day full of knight training.

>x closet
You open your closet to find a piece of paper clipped on to one of your spare uniforms.

>x paper
The note reads: Your equipment is nowhere to be seen... your shield meant to be used to clean. And what about your sword? Where is that? I'll let you know, it's under something hard, and flat.

>take paper
That's hardly portable.

>take paper
That's hardly portable.

>x desk
You usually leave your equipment here for the next day...unfortunately, your equipment is obviously gone.

>x trunk
You open the trunk to find all of your most special possesions: pictures, letters...nothing particularly useful at the moment.

>x pictures
You can't see any such thing.

>x letters
You can't see any such thing.

>take trunk
That's fixed in place.

>x chair
A chair fit for a knight.

>l
Your room
A simple room with wooden flooring, and grey-white walls with an emerald trim: your academy's colors. The only pieces of furniture are your bed, your closet, your desk, a trunk, and a chair. The exit is to the south.

You can see your bed, your chair and a trunk (closed) here.

>i
You are carrying nothing.

>s
hallway
A simple hallway with maps and flyers along the wall. To the north is your room, north east is Pipit's room, east leads further into the academy, west leads outside, south west is to the bathroom, and south leads to the dining hall.

You can see Maps and Flyers here.

>have sex
That's not a verb I recognise.

>ne
Pipit's room
Pipit's room is a little more lively, as he has added more posters to the walls, has placed figurines on his desk, and has a beanbag in the cornner. The exit is to the southwest.

You can see Pipit's bean bag, Pipit's bed, Pipit's posters, Pipit's figurines and Pipit's chair here.

>get in bed with pipit
I only understood you as far as wanting to get in Pipit's bed.

>have sex with pipit
That's not a verb I recognise.

>get in bed
Yeah, probably not a good idea...

>get in bed
Yeah, probably not a good idea...

>hve sex with pipets pillow
That's not a verb I recognise.

>sniff his clothes
You can't see any such thing.

>wank to his items
That's not a verb I recognise.

>enjoy his prescence
That's not a verb I recognise.

>l
Pipit's room
Pipit's room is a little more lively, as he has added more posters to the walls, has placed figurines on his desk, and has a beanbag in the cornner. The exit is to the southwest.

You can see Pipit's bean bag, Pipit's bed, Pipit's posters, Pipit's figurines and Pipit's chair here.

>take figurines
Taken.

>x posters
His posters aren't actually posters...they're drawings he's made. (And very nice ones at that.)

>take posters
That's fixed in place.

>x bean bag
A nice comfortable bean bag that could also be used to hide under to cut class?

>look under bean bag
You find nothing of interest.

>take bean bag
That's fixed in place.

>x chair
Chair.

>have sex with chair
That's not a verb I recognise.

>sw
hallway
A simple hallway with maps and flyers along the wall. To the north is your room, north east is Pipit's room, east leads further into the academy, west leads outside, south west is to the bathroom, and south leads to the dining hall.

You can see Maps and Flyers here.

>x figurines
An small army of mini Skyloftian knights...it seems as though he made these himself, as one is half-painted.

>sw
bathroom
A rather spacious room with  a toilet, a sink, a mirror, and a large tub. The exit is to the north east.

>jerk in bathtub
That's not a verb I recognise.

>x toliet
You can't see any such thing.

>x toilet
A simple toilet.

>x sink
A nice, clean sink.

>x mirror
Looking in the mirror, you see yourself: a strong, disciplined, knight-in-training. You are wearing a green uniform.

>x green uniform
You can't see any such thing.

>x large tub
You can't see any such thing.

>x tub
Made from a natural hotspring, the tub is always full of warm water. Looking closely, though, you see something at the bottom...it looks like you can reach in to grab it.

>reach into tub
You reach your hand inside the tub, and find your shield! (Maybe your should check it to make sure your friends didn't break it.)

>x shield
A shiny, stainless steel shield with a few scratches from sparring matches against your particularly talented classmates. It has the academy crest engraved on it. Attached to the back is what looks like a potion container.

>open container
It isn't something you can open.

>over dose on potions
That's not a verb I recognise.

>get hyped
You can't see any such thing.

>grind on the crest
That's not a verb I recognise.

>x crest
You can't see any such thing.

>x academy crest
You can't see any such thing.

>x potion container
Inside you are able to read a small note.

>x note
The second riddle reads, Ah, so you've found your shield... but you also need a weapon to wield. For training you need no papers or pencils... instead, try looking by the utensils?